####################################################################################################
#                                                                                                  #
#                                                                                                  #
#                                                                                                  #
#                                                                                                  #
#                                                                                                  #
#                                                                                                  #
#                                                                                                  #
#                                                                                                  #
#                                                                                                  #
#                                                                          ######                  #
#                                  ########                                                        #
#                                                                                                  #
#                                                                                                  #
#                                                                                                  #
#                                                                                                  #
#                                                                                                  #
#            #####                       #                                                         #
#                                        #                                                         #
#                                    #####                                                         #
#                                        #                                                         #
#                                        ##########                                                #
#              ########                                                                            #
#         ##################                                                                       #
#    ###############################                                                               #
#  ###################################                                                             #
###############################################################                                    #
####################################################################################################